#####################
#......#.#......#.###
##.......#..........#
#...................#
########............#
#.................###
#..........#........#
#..........####.....#
#####......#........#
#..........#.......##
#.#........#........#
#####################